0000000000000000000000000000000000000000000000000000000000000000000000
0000000000000000000000000000000000000000000000000000000000000000000000
0022220000000000000000000000000000000000000000000000000000000000222200
0024420000000000000000000000000000000000000000000000000000000000244200
0024420000000000000000011111111111111111111111100000000000000000244200
0022220000000000000000011111111111111111111111100000000000000000222200
0000000000000000000000000001122222222222211000000000000000000000000000
0000000000000000000000000001122222222222211000000000000000000000000000
0000000000000000000000000111122333333332211110000000000000000000000000
0000000000000000000000000111122333333332211110000000000000000000000000
0000000000000000000000011111122334444332211111100000000000000000000000
0000000000000000000001111111122334664332211111111000000000000000000000
0000000000000000000001111111122334664332211111111000000000000000000000
0000000000000000000000011111122334444332211111100000000000000000000000
0000000000000000000000000111122333333332211110000000000000000000000000
0000000000000000000000000111122333333332211110000000000000000000000000
0000000000000000000000000001122222222222211000000000000000000000000000
0000000000000000000000000001122222222222211000000000000000000000000000
0022220000000000000000011111111111111111111111100000000000000000222200
0024420000000000000000011111111111111111111111100000000000000000244200
0024420000000000000000000000000000000000000000000000000000000000244200
0022220000000000000000000000000000000000000000000000000000000000222200
0000000000000000000000000000000000000000000000000000000000000000000000
0000000000000000000000000000000000000000000000000000000000000000000000
