0000000000000000000000000000000000000000000000000000000000000000000000
0000000000000000000000000000000000000000000000000000000000000000000000
0000000000000000000000000000000000000000000000000000000000000000000000
0000000000000000000000000000000000000000000000000000000000000000000000
0000000000000000000000110000001100000011000000110000000000000000000000
0000000000000000000000110000001100000011000000110000000000000000000000
0000000000000000000000000000000000000000000000000000000000000000000000
0000000000000000000004444000044440000444400004444000000000000000000000
0000000000000000000004554000045540000455400004554000000000000000000000
0000000000000000000004554000045540000455400004554000000000000000000000
0000000000000000000004444000044440000444400004444000000000000000000000
0000000000000000000000000000000000000000000000000000000000000000000000
0000000000000000000000000000000000000000000000000000000000000000000000
0000000000000000000004444000044440000444400004444000000000000000000000
0000000000000000000004554000045540000455400004554000000000000000000000
0000000000000000000004554000045540000455400004554000000000000000000000
0000000000000000000004444000044440000444400004444000000000000000000000
0000000000000000000000000000000000000000000000000000000000000000000000
0000000000000000000000110000001100000011000000110000000000000000000000
0000000000000000000000110000001100000011000000110000000000000000000000
0000000000000000000000000000000000000000000000000000000000000000000000
0000000000000000000000000000000000000000000000000000000000000000000000
0000000000000000000000000000000000000000000000000000000000000000000000
0000000000000000000000000000000000000000000000000000000000000000000000