0000000000000000000000000000000000000000000000000000000000000000000000
0000000000000000000000000000000000000000000000000000000000000000000000
0000000000000000000000000000000000000000000000000000000000000000000000
0000000000000000000000000033111111111111113300000000000000000000000000
0000000000000000000000000033111111111111113300000000000000000000000000
0000000000000000000000000011111144444444111100000000000000000000000000
0000000000000000000000000011111144444444111100000000000000000000000000
0000000000000000000000000011111144000044111100000000000000000000000000
0000000000000000000000000011111144000044111100000000000000000000000000
0000000000000000000000000011114400000044111100000000000000000000000000
0000000000000000000000000011114400000044111100000000000000000000000000
0000000000000000000000000011440000440044441100000000000000000000000000
0000000000000000000000000011440000440044441100000000000000000000000000
0000000000000000000000000011440000000000441100000000000000000000000000
0000000000000000000000000011440000000000441100000000000000000000000000
0000000000000000000000000011444444440044441100000000000000000000000000
0000000000000000000000000011444444440044441100000000000000000000000000
0000000000000000000000000011111111444444111100000000000000000000000000
0000000000000000000000000011111111444444111100000000000000000000000000
0000000000000000000000000033111111111111113300000000000000000000000000
0000000000000000000000000033111111111111113300000000000000000000000000
0000000000000000000000000000000000000000000000000000000000000000000000
0000000000000000000000000000000000000000000000000000000000000000000000
0000000000000000000000000000000000000000000000000000000000000000000000
