0000000000000000000000000000000000000000000000000000000000000000000000
0000000000000000000000000000000000000000000000000000000000000000000000
0000000000000000000000000000000000000000000000000000000000000000000000
0000000000000000000000000000000000000000000000000000000000000000000000
0000000000000000000000000000000000000000000000000000000000000000000000
0000000000000000000000000000000000000000000000000000000000000000000000
0000000000000000000000000004444444444444444000000000000000000000000000
0000000000000000000000000004444444444444444000000000000000000000000000
0000000000000000000000000002233444444443322000000000000000000000000000
0000000000000000000000000002233444444443322000000000000000000000000000
0000000000000000000000000002233440000443322000000000000000000000000000
0000000000000000000000000002233440000443322000000000000000000000000000
0000000000000000000000000002233440000443322000000000000000000000000000
0000000000000000000000000002233440000443322000000000000000000000000000
0000000000000000000000000002233444444443322000000000000000000000000000
0000000000000000000000000002233444444443322000000000000000000000000000
0000000000000000000000000004444444444444444000000000000000000000000000
0000000000000000000000000004444444444444444000000000000000000000000000
0000000000000000000000000000000000000000000000000000000000000000000000
0000000000000000000000000000000000000000000000000000000000000000000000
0000000000000000000000000000000000000000000000000000000000000000000000
0000000000000000000000000000000000000000000000000000000000000000000000
0000000000000000000000000000000000000000000000000000000000000000000000
0000000000000000000000000000000000000000000000000000000000000000000000
