0000000000000000000000000000000000000000000000000000000000000000000000
0000000000000000000000000000000000000000000000000000000000000000000000
0000000000000000000000000000000000000000000000000000000000000000000000
0000000000000000000000000000000000000000000000000000000000000000000000
0000000000000000000000000000000000000000000000000000000000000000000000
0000000000000000000000554433221100000011223344550000000000000000000000
0000000000000000000000554433221100000011223344550000000000000000000000
0000000000000000000000443322110011221100112233440000000000000000000000
0000000000000000000000443322110011221100112233440000000000000000000000
0000000000000000000000332211000000110000001122330000000000000000000000
0000000000000000000000332211000000110000001122330000000000000000000000
0000000000000000000000221100000011221100000011220000000000000000000000
0000000000000000000000221100000011221100000011220000000000000000000000
0000000000000000000000332211000000110000001122330000000000000000000000
0000000000000000000000332211000000110000001122330000000000000000000000
0000000000000000000000443322110011221100112233440000000000000000000000
0000000000000000000000443322110011221100112233440000000000000000000000
0000000000000000000000554433221100000011223344550000000000000000000000
0000000000000000000000554433221100000011223344550000000000000000000000
0000000000000000000000000000000000000000000000000000000000000000000000
0000000000000000000000000000000000000000000000000000000000000000000000
0000000000000000000000000000000000000000000000000000000000000000000000
0000000000000000000000000000000000000000000000000000000000000000000000
0000000000000000000000000000000000000000000000000000000000000000000000
