0000000000000000000000000000000000000000000000000000000000000000000000
0000000000000000000000000000000000000000000000000000000000000000000000
0000000000000000000000000000000000000000000000000000000000000000000000
0000000000000000000000000000000000000000000000000000000000000000000000
0000000000000000000000000000000000000000000000000000000000000000000000
0000000000000000000000033221100112211001122330000000000000000000000000
0000000000000000000000033221100112211001122330000000000000000000000000
0000000000000000000000022110011223322110011220000000000000000000000000
0000000000000000000000022110011223322110011220000000000000000000000000
0000000000000000000000011001122334433221100110000000000000000000000000
0000000000000000000000011001122334433221100110000000000000000000000000
0000000000000000000000000112233445544332211000000000000000000000000000
0000000000000000000000000112233445544332211000000000000000000000000000
0000000000000000000000011001122334433221100110000000000000000000000000
0000000000000000000000011001122334433221100110000000000000000000000000
0000000000000000000000022110011223322110011220000000000000000000000000
0000000000000000000000022110011223322110011220000000000000000000000000
0000000000000000000000033221100112211001122330000000000000000000000000
0000000000000000000000033221100112211001122330000000000000000000000000
0000000000000000000000000000000000000000000000000000000000000000000000
0000000000000000000000000000000000000000000000000000000000000000000000
0000000000000000000000000000000000000000000000000000000000000000000000
0000000000000000000000000000000000000000000000000000000000000000000000
0000000000000000000000000000000000000000000000000000000000000000000000
