0000000000000000000000000000000000000000000000000000000000000000000000
0000000000000000000000000000000000000000000000000000000000000000000000
0000000000000000000000000000000000000000000000000000000000000000000000
0000000000000000000000000000000000000000000000000000000000000000000000
0000000000000000000000000000000000000000000000000000000000000000000000
0000000000000000000000002222022220220222202222000000000000000000000000
0000000000000000000000003333033330330333303333000000000000000000000000
0000000000000000000000003333033330330333303333000000000000000000000000
0000000000000000000000002222022220440222202222000000000000000000000000
0000000000000000000000000000000000440000000000000000000000000000000000
0000000000000000000000002222022220440222202222000000000000000000000000
0000000000000000000000003333033330440333303333000000000000000000000000
0000000000000000000000003333033330440333303333000000000000000000000000
0000000000000000000000002222022220440222202222000000000000000000000000
0000000000000000000000000000000000440000000000000000000000000000000000
0000000000000000000000002222022220440222202222000000000000000000000000
0000000000000000000000003333033330330333303333000000000000000000000000
0000000000000000000000003333033330330333303333000000000000000000000000
0000000000000000000000002222022220220222202222000000000000000000000000
0000000000000000000000000000000000000000000000000000000000000000000000
0000000000000000000000000000000000000000000000000000000000000000000000
0000000000000000000000000000000000000000000000000000000000000000000000
0000000000000000000000000000000000000000000000000000000000000000000000
0000000000000000000000000000000000000000000000000000000000000000000000
