0000000000000000000000000000000000000000000000000000000000000000000000
0000000000000000000000000000000000000000000000000000000000000000000000
0000000000000000000000000000000000000000000000000000000000000000000000
0000000000000000000000000000000000000000000000000000000000000000000000
0000000000000000000000000000000000000000000000000000000000000000000000
0000000000000000000000000000000000000000000000000000000000000000000000
0000000000000000000000000332233223333223322330000000000000000000000000
0000000000000000000000000332233223333223322330000000000000000000000000
0000000000000000000000033220000000000000000223300000000000000000000000
0000000000000000000000033220000000000000000223300000000000000000000000
0000000000000000000000022004400440330440044002200000000000000000000000
0000000000000000000000022004400440330440044002200000000000000000000000
0000000000000000000000033220000000000000000223300000000000000000000000
0000000000000000000000033220000000000000000223300000000000000000000000
0000000000000000000000000332233223333223322330000000000000000000000000
0000000000000000000000000332233223333223322330000000000000000000000000
0000000000000000000000000000000000000000000000000000000000000000000000
0000000000000000000000000000000000000000000000000000000000000000000000
0000000000000000000000000000000000000000000000000000000000000000000000
0000000000000000000000000000000000000000000000000000000000000000000000
0000000000000000000000000000000000000000000000000000000000000000000000
0000000000000000000000000000000000000000000000000000000000000000000000
