0000000000000000000000000000000000000000000000000000000000000000000000
0000000000000000000000000000000000000000000000000000000000000000000000
0022005500110011001100110011001100110000000000000000000000000000000000
0022005500110011001100110011001100110000000000000000000000000000000000
0011111111111111111111111111111111110000000000000000000000000000000000
0015511111111111111111111111111111110000000000000000000000000000000000
0015511111111111111111111111111111110000000000000000000000000000000000
0011111111111111111111111111111111110000000000000000000000000000000000
0011111111111111111111111111111111110000000000000000000000000000000000
0012211221111111111111111111111111110000000000000000000000000000000000
0012211221111111111111111111111111110000000000000000000000000000000000
0011111111111111111111111111111111110000000000000000000000000000000000
0011111111111111111111111111111111110000000000000000000000000000000000
0011111111111111111111111111111111110000000000000000000000000000000000
0011111111111111111111111111111111110000000000000000000000000000000000
0011111111111111111111111111111111110000000000000000000000000000000000
0011111111111111111111111111111111110000000000000000000000000000000000
0011111111111111111111111111111111110000000000000000000000000000000000
0011111111111111111111111111111111110000000000000000000000000000000000
0011111111111111111111111111111111110000000000000000000000000000000000
0011111111111111111111111111111111110000000000000000000000000000000000
0011111111111111111111111111111111110000000000000000000000000000000000
0000000000000000000000000000000000000000000000000000000000000000000000
0000000000000000000000000000000000000000000000000000000000000000000000
